133131313131313131313131313131313131313131313131313131313131313131313131313131313131313131313131313131313131313131313114
220000000000000000000000000000000000000000000000000000000000000000000000000000000000000000000000000000000000000000000020
220000000000000000000000000000000000000000000000000000000000000000000000000000000000000000000000000000000000000000000020
220000000000000000000000000000000000000000000000000000000000000000000035363637000000000000000000000000000000000000000020
220000000000000000000000000000000000000000000000000000000000000000000000000000000000001011111111111112000000151616170020
220000000000000000000000000015161617000000000000000000000035363700000000000000000000002021212121212122000000252626270020
220000000000000000000000000025262627000000000010111112000000000000000000000000000000003031313131313132000000252626270020
220000000000000000000000000025262627000000000030313132000000000000000000000000000000000000000000000000000000252626270020
220000000015161617000000151616161616161617000000000000000000000000000000000000000000000000000000000000000000252626270020
220000000025262627000000252626262626262627000000000000000000000000000000000000000000000000000000000000000000252626270020
231111111111111111111111111111111111111111111111111111111111111111111111111111111111111111111111111111111111111111111124

image image:graphics
sprite @2,9 sprite:hero (u32)0
