133131313131313131313131313131313131313131313131313131313131313131313131313131313131313131313131313131313131313131313114
220018000000000000000018000000000000001800000000000000180000000000001800000000001800000000000000180000000000000018000020
22002800000000000000002800000000000000380000000000000028000000000000290a0a0a0a0a2b00000000000000280000000000000038000020
220028000400000000000038000000000035363700000000000000280000000000002800000000002800000000000000380000353636363637000020
220028010202030000003536363700000000001800000035363637290a0a0a0a0a0a2b0035363700290a0a0a0a0b3536370000000000000018000020
2200290a0a0a0a0a0a0a0a2b00000000000000280000000000000028003536370000280000000000280000000000000029090a0a0a0a0a0a2b000020
22092b00000000000000002800000000000000290a0a0a0a0a0a0a2b00000000000028000000000028003536363636363637000000000000290a0b20
2200280000000000000000290a0a0a0a0a0a0a2b0000000000000038000000000000290a0a0a0a0a2b00000000000000380000000000000028000020
220028000035363637000028001011111200002800000010111111111235363636363637101111111111111111111111111111120000000028000020
220038000000000000000038002021212200003800000020212121212200000000002900202121212121212121212121212121220000000038000020
231111111111111111111111112421212311111111111124212121212311111111111111242121212121212121212121212121231111111111111124

image image:graphics
goal @6,3
goal @3,3
goal @4,3
goal @5,3
sprite @30,9 sprite:powerup_ghost (u8:index)0 (u24)0
sprite @56,1 sprite:powerup_bird (u8:index)2 (u24)0
sprite @39,6 sprite:coin (u8:index)7 (u24)0
sprite @7,6 sprite:coin (u8:index)1 (u24)0
sprite @18,8 sprite:coin (u8:index)5 (u24)0
sprite @34,8 sprite:coin (u8:index)6 (u24)0
sprite @55,8 sprite:coin (u8:index)8 (u24)0
sprite @30,3 sprite:coin (u8:index)22 (u24)0
sprite @3,9 sprite:hero (u32)0
sprite @32,9 sprite:soldier (u32)0
sprite @53,2 sprite:soldier (u32)0
sprite @20,9 sprite:soldier (u32)0
sprite @25,3 sprite:soldier (u32)0
