133131313131313131313131313131313131313131313131313131313131313131313131313131313131313131313131313131313131313131313114
220000000000000000000000000000000000000000000000000000000000000000000000000000000000000000000000000000000000000000000020
220000000000000000000000000000000000000000000000000000000000000000000000000000000000000000000000000000000000000000000020
220000000400000000000000000000000035363700000000000000000000000000000000000000000000000000000000000000353636363637000020
220000010202030000003536363700000000000000000035363637000000000000000000353637000000000000001516170000000000000000000020
220000000000000000000000000000000000000000000000000000000035363700000000000000000000000000002526270000000000000000000020
220000000000000000000000000000000000000000000000000000000000000000000000000000000000151616161616161700000000000000000020
220000000000000000000000000000000000000000000000000000000000000000000000000000000000252626262626262700000000000000000020
220000000015161617000000001011111200000000000010111111111215161616161617101111111111111111111111111111120000000000000020
220000000025262627000000002021212200000000000020212121212225262626262627202121212121212121212121212121220000000000000020
231111111111111111111111112421212311111111111124212121212311111111111111242121212121212121212121212121231111111111111124

image image:graphics
sprite @3,9 sprite:hero (u32)0
goal @6,3
goal @3,3
goal @4,3
goal @5,3
sprite @30,9 sprite:powerup_ghost (u8:index)0 (u24)0
sprite @56,1 sprite:powerup_bird (u8:index)2 (u24)0
sprite @32,9 sprite:soldier (u32)0
sprite @53,2 sprite:soldier (u32)0
sprite @20,9 sprite:soldier (u32)0
sprite @25,3 sprite:soldier (u32)0
sprite @39,6 sprite:coin (u8:index)7 (u24)0
sprite @7,6 sprite:coin (u8:index)1 (u24)0
sprite @18,8 sprite:coin (u8:index)5 (u24)0
sprite @34,8 sprite:coin (u8:index)6 (u24)0
sprite @55,8 sprite:coin (u8:index)8 (u24)0
sprite @30,3 sprite:coin (u8:index)22 (u24)0
