133131313131313131313131313131313131313131313131313131313131313131313131313131313131313131313131313131313131313131313114
220000000000000000000000000000000000000000000000000000000000000000000000000000000000000000000000000000000000000000000020
220000000000000000000000000000000000000000000000000000000000000000000000000000000000000000000000000000000000000000000020
220000000000000000000000000000000000000000000000000000000000000000000035363637000000000000000000000000000000000004000020
220000353636370000000000000000000000000000000000000000000000000000000000000000000000001011111111111112000000010202030020
220000000000000000000000000015161617000000000000000000000035363700000000000000000000002021212121212122000000000000000020
220000000000000000000000000025262627000000000010111112000000000000000000000000000000003031313131313132000000000000000020
220000000000000000000000000025262627000000000030313132000000000000000000000000000000000000000000000000000000000000000020
220000000015161617000000151616161616161617000000000000000000000000000000000000000000000000000000000000000000000000000020
220000000025262627000000252626262626262627000000000000000000000000000000000000000000000000000000000000000000000000000020
231111111111111111111111111111111111111111111111111111111111111111111111111111111111111111111111111111111111111111111124

image image:graphics
sprite @2,9 sprite:hero (u32)0
goal @57,3
goal @54,3
goal @55,3
goal @56,3
sprite @15,7 sprite:soldier (u32)0
sprite @55,3 sprite:soldier (u32)0
sprite @7,7 sprite:soldier (u32)0
sprite @4,3 sprite:soldier (u32)0
sprite @16,4 sprite:soldier (u32)0
sprite @25,5 sprite:soldier (u32)0
sprite @30,4 sprite:soldier (u32)0
sprite @37,2 sprite:soldier (u32)0
sprite @44,3 sprite:soldier (u32)0
sprite @36,7 sprite:powerup_ghost (u8:index)0 (u24)0
sprite @41,8 sprite:powerup_rabbit (u8:index)1 (u24)0
sprite @45,8 sprite:powerup_bird (u8:index)2 (u24)0
