2121212121212113313131313131313131313114212113313131313131313131313131311421212121212121212121212121
2121212121212122000000000000000000000020212122000000000000000000000000002021212121212121212121212121
2121212121212122000000000000000000000030313132000000000000000000000000002021212121212121212121212121
2121212121212122000000000000000000000000000000000000000000000000000000002021212121212121212121212121
2121212121212122000000000000000000000000000000000000000000000000000000002021212121212121212121212121
2121212121212122000000000000000000000000000000000000000000001011111111112421212121212121212121212121
1331313131313132000000000000000000000000000000000000000000002021212121212121212121212121212121212121
2200000000000000000000000000000000000000000000000000000035373031313131313131313131313131313131313114
2200000000000000000000000000000000000010111112000000000000000000000000000000000000000000000000000020
2200000000000000000000353636363637000020212122353636363700000000000000000000000000000000000000000020
2200000000000000000000000000000000000020212122000000000000000000000010120000000000000000000000000020
2200003536363636363700000000000000000020212122000000353637000000000030320000000000000000000000000020
2200000000000000000000000000000000000020212122000000000000001012000000000000000000000000000000000020
2200000000000000000000000035363636370020212123111111111111112423111111111111111111111200000000001024
2200000000000000000000000000000000000020212121212121212121212121212121212121212121133200000000003014
2311120000000010111111111111111111111124212113313131313131313131313131313131313114220000353637000020
1331323536363730313131313131313131313114212122000000000000000000000000000000000020220000000000000020
2200000000000000000000000000000000000020212122000000000000000000000000000000000020220035370035370020
2200003536363700000000000000000000000020212122000000000000000000000000000000000020220000000000000020
2200000000000000000000000000000000000020212122000000000000000000000000000000000020220000353637000020
2200003536363700000000000000000000000020212122000000000000040000000000000000000020220000000000000020
2200000000000000000000000000000000000020212122000000010202020202030000000000000020220035370035370020
2311111111111111111111111200000000101124212122000000000000000000000000000000000020220000000000000020
1331313131313131313131313235363637303114212122000000000000003536363637000000000020220000353637000020
2200000000000000000000000000000000000020212122000000000000000000000000000000000020220000000000000020
2200000000000000000000000035363637000020212122000000000000000000353636363700000030320035370035370020
2200000000000000000000000000000000000020212122000000000000000000000000000000000000000000000000000020
2200000000000000000000000035363637000020212122000000000000000000000035363636370000000000353637000020
2200000000000000000000000000000000000020212122000000000000000000000000000000000010120000000000000020
2311111111111111111111111111111111111124212123111111111111111111111111111111111124231111111111111124

image image:graphics
sprite @33,3 sprite:powerup_rabbit (u8:index)3 (u24)0
sprite @4,28 sprite:hero (u32)0
sprite @9,14 sprite:soldier (u32)0
sprite @32,4 sprite:soldier (u32)0
sprite @14,26 sprite:soldier (u32)0
goal @32,20
goal @26,20
goal @27,20
goal @28,20
goal @29,20
goal @30,20
goal @31,20
sprite @39,12 sprite:specialforces (u32)0
sprite @9,21 sprite:specialforces (u32)0
sprite @14,8 sprite:specialforces (u32)0
sprite @27,28 sprite:specialforces (u32)0
sprite @8,27 sprite:coin (u8:index)9 (u24)0
sprite @17,20 sprite:coin (u8:index)10 (u24)0
sprite @2,13 sprite:coin (u8:index)11 (u24)0
sprite @15,7 sprite:coin (u8:index)12 (u24)0
sprite @24,11 sprite:coin (u8:index)13 (u24)0
sprite @48,11 sprite:coin (u8:index)14 (u24)0
sprite @30,27 sprite:coin (u8:index)15 (u24)0
sprite @24,27 sprite:coin (u8:index)16 (u24)0
