1331313131313131313131313131313131313131313131313131313131313131313131313131313131313131313131313114
2200000000000000000000000000000000000000000000000000000000000000000000000000000000000000000000000020
2200000000000000000000000000000000000000000000000000000000000000000000000000000000000000000000000020
2200000000000000000000000000000000000000000000000000000000000000000000000000000000000000000000000020
2200000000000000000000000000000000000000000000000000000000000000000000000000000000000000000000000020
2200000000000000000000000000000000000000000000000000000000003536363637000000000000000000000000000020
2200000000000000000000000000000000000000000000000000000000000000000000000000000000000000000000000020
2200000000000000000000000000000000000000000000000000000035363636370000000000000000000000000000000020
2200000000000000000000000000000000000000000000000000000000000000000000000000000000000000000000000020
2200000000000000000000000000000000000000000000353636363700000000000000000000000000000000000000000020
2200000000000000000000000000000000000000000000000000000000000000000000000000000000000000000000000020
2200000000000000000000000000000000000000000000000000353636363700000000000000000000000000000000000020
2200000000000000000000000000000000000000000000000000000000000000000000000000000000000000000000000020
2200000000000000000000000000000000000000000035363636363637000000000000000000000000000000000000000020
2200000000000000000000000000000000000000000000000000000000000000000000000000000000000000000000000020
2200000000000035363636363636363636363637000000000000000000000000000000000000003536363637000000000020
2200000000000000000000000000000000000000000000000000000000000000000000000000000000000000000000000020
2200000000000000000000000000000000003536370000000000000000000000000000000000003536363637000000000020
2200000000000000000000000000000000000000000000000000000000000000000000000000000000000000000000000020
2200000000000000000000000000353637000000000000000000000000040000000000000000003536363637000000000020
2200000000000000000000000000000000000000000000000000010202020202030000000000000000000000000000000020
2200000000000000000035363700000000000000000000000000000000000000000000000000003536363637000000000020
2200000000000000000000000000000000000000000000000000000000000000000000000000000000000000000000000020
2200000000003536370000000000000000000000000000000000000000000000000000000000003536363637000000000020
2200000000000000000000000000000000000000000000000000000000000000000000000000000000000000000000000020
2200000000000000000035363700000000000000000000000000000000000000000000000000003536363637000000000020
2200000000000000000000000000000000000000000000000000000000000000000000000000000000000000000000000020
2200000000000000000000000000353637000000000000000000000000000000000000000000003536363637000000000020
2200000000000000000000000000000000000000000000000000000000000000000000000000000000000000000000000020
2311111111111111111111111111111111111111111111111111111111111111111111111111111111111111111111111124

image image:graphics
sprite @10,14 sprite:hero (u32)0
sprite @34,28 sprite:soldier (u32)0
sprite @41,22 sprite:soldier (u32)0
sprite @32,4 sprite:soldier (u32)0
sprite @12,28 sprite:soldier (u32)0
goal @32,19
goal @26,19
goal @27,19
goal @28,19
goal @29,19
goal @30,19
goal @31,19
