2121212121212113313131313131313131313114212113313131313131313131313131311421212121212121212121212121
2121212121212122000000000018000000000020212122000000180000000000180000002021212121212121212121212121
2121212121212122000000000028000000000030313132000000280000000000280000002021212121212121212121212121
2121212121212122000000000028000000000000180000000000280000000000280000002021212121212121212121212121
2121212121212122000000000028000000000000290a0a0a0a0a2a0a0a0a0a0a2a0a0a0b2021212121212121212121212121
2121212121212122090a0a0a0a2b000000000000280000000000280000001011111111112421212121212121212121212121
1331313131313132000000000028000000000000280000000000280000002021212121212121212121212121212121212121
2200000000180000000000000028000000000000380000000000280035373031313131313131313131313131313131313114
2200000000280000000000000038000000000010111112000000380000000000180000000000180000000000001800000020
220000000028000000000035363636363700002021212235363636370000000028000000000028000000000000290a0a0b20
22000000003800000000000000290a0a0a0a0b20212122000000380000000000290b1012090a2b0000000000002800000020
22090b35363636363637090a0a2b0000000000202121220a0a0a353637000000280030320000290a0a0a0a0a0a2b00000020
2200001800000000180000000038000000000020212122000000380000001012380000000000380000000000002800000020
2200002800000000280000000035363636370020212123111111111111112423111111111111111111111200002800001024
2200002800000000380000000038000000000020212121212121212121212121212121212121212121133200003800003014
2311123800000010111111111111111111111124212113313131313131313131313131313131313114220000353637090b20
1331323536363730313131313131313131313114212122000000000018000000000000000018000020220000001800000020
220000380000000018000000001800000000002021212200000000002800000000000000002800002022090a0a2b35370020
22090b35363637092b00000000290a0a0a0a0b20212122000000000028000000000000000028000020220000003800000020
2200003800000000280000000028000000000020212122090a0a0a0a2a0a0a0a0a0a0a0a0a2a0a0b20220000353637000020
22000035363637092a0a0a0a0a2b000000000020212122000000000038040000000000000028000020220000001800000020
2200003800000000380000000028000000000020212122000000010202020202030000000028000020220035372935370a20
2311111111111111111111111238000000101124212122000000000018000000000000000028000020220000003800000020
1331313131313131313131313235363637303114212122090a0a0a0a2a0b3536363637090a2a0a0b20220000353637000020
22090a2b00000000180000000038000000000020212122000000000028000000000000000028000020220000001800000020
2200002800000000280000000035363637090b20212122000000000028000000353636363728000030320035372835370020
220000290a0a0a0a2b0000000028000000000020212122000000000028000000000000000038000000000000003800000020
2200002800000000290a0a0a0b35363637000020212122000000000028000000000035363636370000000000353637000020
2200003800000000380000000028000000000020212122000000000038000000000000000038000010120000003800000020
2311111111111111111111111111111111111124212123111111111111111111111111111111111124231111111111111124

image image:graphics
sprite @33,3 sprite:powerup_rabbit (u8:index)3 (u24)0
sprite @8,27 sprite:coin (u8:index)9 (u24)0
sprite @17,20 sprite:coin (u8:index)10 (u24)0
sprite @2,13 sprite:coin (u8:index)11 (u24)0
sprite @15,7 sprite:coin (u8:index)12 (u24)0
sprite @24,11 sprite:coin (u8:index)13 (u24)0
sprite @48,11 sprite:coin (u8:index)14 (u24)0
sprite @30,27 sprite:coin (u8:index)15 (u24)0
sprite @24,27 sprite:coin (u8:index)16 (u24)0
sprite @4,28 sprite:hero (u32)0
sprite @9,14 sprite:soldier (u32)0
sprite @32,4 sprite:soldier (u32)0
sprite @14,26 sprite:soldier (u32)0
goal @32,20
goal @26,20
goal @27,20
goal @28,20
goal @29,20
goal @30,20
goal @31,20
sprite @39,12 sprite:specialforces (u32)0
sprite @9,21 sprite:specialforces (u32)0
sprite @14,8 sprite:specialforces (u32)0
sprite @27,28 sprite:specialforces (u32)0
