13313131313131313131313131313131313131313131313131313131313131313131313131313114
22000000001800000000001800000000000000180000000000000000180000000000180000000020
22000000002800000000002800000000000000290a0a0a0a0a0a0a0a2b0000000000280000000020
2200000000290a0a0a0a0a2b00000000000000280000000000000000280000000000290a0a0a0b20
2200000000280000000000290a0a0a0a0a0a0a2b0000000000000000280000000000280000000020
22000000003800000000002800000000000000280000000000000000290a0a0a0a0a2b0000000020
23111111111112000000002800000010120000380000000000000000280000000000280000000020
21212121212122000000003800000020220000101200000000000000280000000000280000000020
21212121212123111111111111111124220000303200001012000000380000000000280000000020
21212121212121212121212121212121220000180000003032000010120000000000280000000020
21212121212121212121212121212121220000290a0a0a0a0a0a0b30320000101200290a0a0a0b20
21211331313131313131142121212121220000280000000000000000180000303200281012000020
21212200001800000000202121212121220000280000000000000000280000000000283032000020
212122090a2b0000000020212121212122090a2b0000000000000000290a0a0a0a0a2b0000000020
21212200003804000000303131313131320000280000000000000000280000000000280000000020
21212200010202020300001800000000000000280000000000000000280000000000280000000020
13313200001800000000002800000000000000380000000000000000380000000000380000000020
2200000000290a0a0a0a0a2b10111111111111111111111111111111111111111111111111111124
22000000003800000000003820212121212121212121212121212121212121212121212121212121
23111111111111111111111124212121212121212121212121212121212121212121212121212121

image image:graphics
sprite @35,9 sprite:powerup_bird (u8:index)4 (u24)0
sprite @12,6 sprite:coin (u8:index)17 (u24)0
sprite @16,3 sprite:coin (u8:index)23 (u24)0
sprite @1,17 sprite:coin (u8:index)19 (u24)0
sprite @34,15 sprite:coin (u8:index)20 (u24)0
sprite @37,8 sprite:coin (u8:index)21 (u24)0
sprite @21,4 sprite:coin (u8:index)18 (u24)0
sprite @2,5 sprite:hero (u32)0
sprite @6,18 sprite:specialforces (u32)0
sprite @27,8 sprite:specialforces (u32)0
sprite @27,16 sprite:soldier (u32)0
sprite @19,16 sprite:soldier (u32)0
sprite @9,7 sprite:specialforces (u32)0
goal @8,14
goal @4,14
goal @5,14
goal @6,14
goal @7,14
