13313131313131313131313131313131313131313131313131313131313131313131313131313114
22000000000000000000000000000000000000000000000000000000000000000000000000000020
22000000000000000000000000000000000000000000000000000000000000000000000000000020
22000000000000000000000000000000000000000000000000000000000000000000000000000020
22000000000000000000000000000000000000000000000000000000000000000000000000000020
22000000000000000000000000000000000000000000000000000000000000000000000000000020
23111111111112000000000000000010120000000000000000000000000000000000000000000020
21212121212122000000000000000020220000101200000000000000000000000000000000000020
21212121212123111111111111111124220000303200001012000000000000000000000000000020
21212121212121212121212121212121220000000000003032000010120000000000000000000020
21212121212121212121212121212121220000000000000000000030320000101200000000000020
21211331313131313131142121212121220000000000000000000000000000303200001012000020
21212200000000000000202121212121220000000000000000000000000000000000003032000020
21212200000000000000202121212121220000000000000000000000000000000000000000000020
21212200000004000000303131313131320000000000000000000000000000000000000000000020
21212200010202020300000000000000000000000000000000000000000000000000000000000020
13313200000000000000000000000000000000000000000000000000000000000000000000000020
22000000000000000000000010111111111111111111111111111111111111111111111111111124
22000000000000000000000020212121212121212121212121212121212121212121212121212121
23111111111111111111111124212121212121212121212121212121212121212121212121212121

image image:graphics
sprite @35,9 sprite:powerup_bird (u8:index)4 (u24)0
sprite @2,5 sprite:hero (u32)0
sprite @6,18 sprite:specialforces (u32)0
sprite @27,8 sprite:specialforces (u32)0
sprite @27,16 sprite:soldier (u32)0
sprite @19,16 sprite:soldier (u32)0
sprite @9,7 sprite:specialforces (u32)0
goal @8,14
goal @4,14
goal @5,14
goal @6,14
goal @7,14
sprite @12,6 sprite:coin (u8:index)17 (u24)0
sprite @16,3 sprite:coin (u8:index)23 (u24)0
sprite @1,17 sprite:coin (u8:index)19 (u24)0
sprite @34,15 sprite:coin (u8:index)20 (u24)0
sprite @37,8 sprite:coin (u8:index)21 (u24)0
sprite @21,4 sprite:coin (u8:index)18 (u24)0
